
xxxxxxxxxxxxxxxxyyyyyyyyyyyyyyyzzzzzzzzzz	NONE

absorbsion                         absorbing                          	 (ins->g)  n  (del->o)  i  (del->s)  b  r  o  s  b  a 

abundacies                         abundance                          	 (del->s)  e  (del->i)  c  (ins->n)  a  d  n  u  b  a 

accomadate                         accommodate                        	 e  t  a  d  (chg->a,o)  (ins->m)  m  o  c  c  a 

acheivments                        achievements                       	 s  t  n  e  m  (ins->e)  v  (del->i)  e  (ins->i)  h  c  a 

acquiantence                       acquaintance                       	 e  c  n  (chg->e,a)  t  n  (del->a)  i  (ins->a)  u  q  c  a 

acquiantences                      acquaintances                      	 s  e  c  n  (chg->e,a)  t  n  (del->a)  i  (ins->a)  u  q  c  a 

acustommed                         accustomed                         	 d  e  (del->m)  m  o  t  s  u  (ins->c)  c  a 

belives                            belies                             	 s  e  (del->v)  i  l  e  b 

beng                               beg                                	 g  (del->n)  e  b 

bizzare                            bizarre                            	 e  (ins->r)  r  a  (del->z)  z  i  b 

blaim                              baim                               	 m  i  a  (del->l)  b 

blessure                           lesure                             	 e  r  u  (del->s)  s  e  l  (del->b) 

boaut                              boat                               	 t  (del->u)  a  o  b 

borke                              bore                               	 e  (del->k)  r  o  b 

brasillian                         brasilia                           	 (del->n)  a  i  (del->l)  l  i  s  a  r  b 

broacasted                         boasted                            	 d  e  t  s  (del->a)  (del->c)  a  o  (del->r)  b 

broady                             	OK

buring                             bring                              	 g  n  i  r  (del->u)  b 

buring                             bring                              	 g  n  i  r  (del->u)  b 

buring                             bring                              	 g  n  i  r  (del->u)  b 

dissapearing                       disappearing                       	 g  n  i  r  a  e  (ins->p)  p  a  (del->s)  s  i  d 

dissapears                         disappears                         	 s  r  a  e  (ins->p)  p  a  (del->s)  s  i  d 

dissobediance                      disobedience                       	 e  c  n  (chg->a,e)  i  d  e  b  o  (del->s)  s  i  d 

dissobediant                       disobedient                        	 t  n  (chg->a,e)  i  d  e  b  o  (del->s)  s  i  d 

doens                              dens                               	 s  n  e  (del->o)  d 

duting                             dusting                            	 g  n  i  t  (ins->s)  u  d 

earnt                              earn                               	 (del->t)  n  r  a  e 

ecidious                           deciduous                          	 s  u  o  (chg->i,u)  d  i  c  e  (ins->d) 

ecomonic                           comic                              	 c  i  (del->n)  (del->o)  m  o  c  (del->e) 

efel                               eel                                	 l  e  (del->f)  e 

eigth                              eighth                             	 h  t  (ins->h)  g  i  e 

electricly                         electric                           	 (del->y)  (del->l)  c  i  r  t  c  e  l  e 

embezelled                         embezzled                          	 d  e  (del->l)  l  (chg->e,z)  z  e  b  m  e 

emition                            edition                            	 n  o  i  t  i  (chg->m,d)  e 

herad                              head                               	 d  a  (del->r)  e  h 

interrugum                         interregnum                        	 m  u  (ins->n)  g  (chg->u,e)  r  r  e  t  n  i 

ironicly                           ironic                             	 (del->y)  (del->l)  c  i  n  o  r  i 

iwll                               ill                                	 l  l  (del->w)  i 

judisuary                          diary                              	 y  r  a  (del->u)  (del->s)  i  d  (del->u)  (del->j) 

kwno                               kano                               	 o  n  (chg->w,a)  k 

layed                              flayed                             	 d  e  y  a  l  (ins->f) 

leanr                              lean                               	 (del->r)  n  a  e  l 

lenght                             engh                               	 (del->t)  h  g  n  e  (del->l) 

lisence                            licence                            	 e  c  n  e  (chg->s,c)  i  l 

litature                           literature                         	 e  r  u  t  a  (ins->r)  (ins->e)  t  i  l 

maintainance                       maintenance                        	 e  c  n  a  n  (chg->i,e)  (del->a)  t  n  i  a  m 

maintinaing                        maintaining                        	 g  n  i  (del->a)  n  i  (ins->a)  t  n  i  a  m 

maintioned                         maintained                         	 d  e  n  (del->o)  i  (ins->a)  t  n  i  a  m 

maked                              make                               	 (del->d)  e  k  a  m 

maltesian                          artesian                           	 n  a  i  s  e  t  (chg->l,r)  a  (del->m) 

markes                             makes                              	 s  e  k  (del->r)  a  m 

nessecary                          essary                             	 y  r  a  (del->c)  (del->e)  s  s  e  (del->n) 

nkwo                               ko                                 	 o  (del->w)  k  (del->n) 

nucular                            nuclear                            	 r  a  (ins->e)  l  (del->u)  c  u  n 

obstacal                           obstacle                           	 (ins->e)  l  (del->a)  c  a  t  s  b  o 

obstruced                          obstructed                         	 d  e  (ins->t)  c  u  r  t  s  b  o 

owrk                               bork                               	 k  r  (del->w)  o  (ins->b) 

owudl                              owl                                	 l  (del->d)  (del->u)  w  o 

palistian                          alsatian                           	 n  a  i  t  (ins->a)  s  (del->i)  l  a  (del->p) 

pallete                            pallet                             	 (del->e)  t  e  l  l  a  p 

pamflet                            amulet                             	 t  e  l  (chg->f,u)  m  a  (del->p) 

parituclar                         particular                         	 r  a  l  (del->c)  u  (chg->t,c)  i  (ins->t)  r  a  p 

parralel                           parallel                           	 l  e  (ins->l)  l  a  (del->r)  r  a  p 

representive                       representative                     	 e  v  i  (ins->t)  (ins->a)  t  n  e  s  e  r  p  e  r 

responnsibilty                     responsibility                     	 y  t  (ins->i)  l  i  b  i  s  (del->n)  n  o  p  s  e  r 

ressemblence                       resemblance                        	 e  c  n  (chg->e,a)  l  b  m  e  (del->s)  s  e  r 

ressurection                       resurrection                       	 n  o  i  t  c  e  (ins->r)  r  u  (del->s)  s  e  r 

restaraunt                         restaurant                         	 t  n  (del->u)  a  r  (ins->u)  a  t  s  e  r 

surreptiously                      surreptitiously                    	 y  l  s  u  o  (ins->i)  (ins->t)  i  t  p  e  r  r  u  s 

surveilence                        surveillance                       	 e  c  n  (chg->e,a)  (ins->l)  l  i  e  v  r  u  s 

suseptable                         susceptible                        	 e  l  b  (chg->a,i)  t  p  e  (ins->c)  s  u  s 

symettric                          metric                             	 c  i  r  (del->t)  t  e  m  (del->y)  (del->s) 

symmetral                          symmetrical                        	 l  a  (ins->c)  (ins->i)  r  t  e  m  m  y  s 

sysmatically                       systematically                     	 y  l  l  a  c  i  t  a  m  (ins->e)  (ins->t)  s  y  s 

tahn                               ahn                                	 n  h  a  (del->t) 

taht                               tat                                	 t  (del->h)  a  t 

tath                               tat                                	 (del->h)  t  a  t 

teached                            ached                              	 d  e  h  c  a  (del->e)  (del->t) 

teh                                eh                                 	 h  e  (del->t) 

tehy                               techy                              	 y  h  (ins->c)  e  t 

telelevision                       television                         	 n  o  i  s  i  v  (del->e)  (del->l)  e  l  e  t 

unsuprized                         prized                             	 d  e  z  i  r  p  (del->u)  (del->s)  (del->n)  (del->u) 

unweildly                          unwell                             	 (del->y)  l  (del->d)  l  (del->i)  e  w  n  u 

vailidty                           validity                           	 y  t  (ins->i)  d  i  l  (del->i)  a  v 

vell                               ell                                	 l  l  e  (del->v) 

verison                            eison                              	 n  o  s  i  (del->r)  e  (del->v) 

versitilaty                        versatility                        	 y  t  (chg->a,i)  l  i  t  (chg->i,a)  s  r  e  v 

vigeur                             viger                              	 r  (del->u)  e  g  i  v 

vreity                             reit                               	 (del->y)  t  i  e  r  (del->v) 

wnat                               nat                                	 t  a  n  (del->w) 

ws                                 	OK

wtih                               th                                 	 h  (del->i)  t  (del->w) 

xenophoby                          xenophobia                         	 (chg->y,a)  (ins->i)  b  o  h  p  o  n  e  x 

yearm                              year                               	 (del->m)  r  a  e  y 

ytou                               you                                	 u  o  (del->t)  y 

                                                                      	

                                                                      	

                                                                      	

                                                                      	
